1111111
1C00001
10C0001
10P00E1
1111111
